1111111
1100CP1
1E11111
1111111
