1111111111
1P00111111
1000111111
1111111111
